1111111111111111111111111111111111
1E0000000000000C00000C000000000001
1010010100100000101001000000010101
101P010010101010001001000000010101
1111111111111111111111111111111111