1111111111
1E0C0P0C01
1111111111