1111111111
1P0001CEC1
100000C001
1111111111