1111111111
1P0000CEC1
1111111111