1111111111
10010PCEC1
1111111111