1111111111111111
1C1000011E0000C1
100000CC001110C1
10C000CC001110C1
10C000CC00111011
10C000CC001110P1
1111111111111111