1111111111111111
100000011E0000C1
10C000CC001110C1
10C000CC001110C1
10C000CC00111011
10C000CC001110P1
1111111111111111