1111111111111111
100000010E0010C1
10C000CC000110C1
10C000CC001110C1
10C000CC001110C1
10C000CC001110P1
1111111111111111