111111111111111111111111111111111111111
10000000000000000000000000000000000C001
10EP00000000011111110111111111111110001
100000000011111111C00111100011111110001
1000000011111110C00001000C0011111110001
1000011111111C0000000000000011111110001
1001111111C0000000000000011111111000001
10111111C000000000000001111111000000001
101111CCCCCCC0CCCCCC0111111000000000001
101111111111111111110111111000000111001
10111111111111111111011111100C011111001
100000000000011111110111111111111111001
100C00000000011111110000000000000000001
10000000000C011111110000000C00000000001
111111111111111111111111111111111111111