1111111
11XE011
1C00001
1011101
1010001
10C0C01
10C0C01
10C0001
1100001
1001X01
1100001
10X0C01
1100011
1110111
111P111
1111111