1111111
110E011
1C00001
1011101
101X001
10CXC01
10C0C01
10CX001
1100001
1001001
11000X1
1000C01
1100011
1110111
111P111
1111111