1111111
11GEG11
1CG0C01
1011101
101G001
10C0C01
10C0C01
10C0C01
1100C01
1C01001
1100C01
10C0C01
110C011
111C111
111P111
1111111