1111111111
11XEX11111
1C0XC00001
1011100001
1010000001
10C0C00001
111P111111
1111111111