1111111111
110E011111
1CX0C00001
10111X0X01
1X1X000001
10CXCX0X01
111P111111
1111111111