1111111111
110E011111
1C00C00001
1011100001
1010000001
10C0C00001
111P111111
1111111111