1111111111111111111111111111111
10000000000000000000000000000E1
1000X00000000000000000000X00001
100X00000X00000X0000X0000000001
100X00000000X0000X00X00X00X0001
1P000000C00000C00000C00000C0001
1111111111111111111111111111111