111111111
1110E11C1
101001001
101001001
100XX0001
100000001
1110C0001
100X00001
1C1C1C1X1
100C0C001
11X1X1CC1
100C00001
1110CC001
10X010001
100C1C1C1
1C001C1X1
1C001C1C1
10C0C0C01
1X00C0001
111100001
10C00C001
100001111
1X00000X1
1011X1101
101000101
101000101
1C11P01C1
111111111